and	AQMJAgINAgIFBAIJAwcGAgIDBwYGBgcFBgQKCQYGAQcDAwIBBQIBAQcEAgUCCAICAQICAgQCAQICAQIDAgED
ndo	AWQE
dor	AT6TAQ==
orr	AX8=
rra	AX8YMw==
pri	ATZKCUc=
rin	ARxkCSwWAwIR
inc	AYABCUcc
nci	AYABCUc=
cip	AYABCUc=
ipa	AYABCQ==
pal	AYABCR4PAjM=
ali	AQxhEwEIBz0j
lit	AVMtBAU=
ity	AYABCQM5Jg==
ty 	AYABCQNf
y o	ASZaBQQDRg==
 of	AQIDAQECAgQBAgECAQEBAwECAQECAQMBAgICAQEBAQEBAwIBAQECAQEBAgEBAQECBAQBAwECAwIBAQIBAQICAQECAQEEAQECAQECAQECBAEBAQEBAQIBAQIBAQEBAQIBAgIBAQEDAQICAQEBAQEDAQECAQEBBAIBAQMCAQIBAQECAwEBAQEBAQEBAgIDAQICAQEBAgECAgEBAwIBAQIBAgEB
of 	AQIDAQECAgQBAgECAQEBAwECAQECAQMBAgICAQEBAQEBAwIBAQECAQEBAgEBAQECBAQBAwECAwIBAQIBAQICAQECAQEEAQECAQECAQECBAEBAQEBAQIBAQIBAQEBAQIBAgIBAQEDAQICAQEBAQEDAQECAQEBBAIBAQMCAQIBAQECAwEBAQEBAQEBAgIDAQICAQEBAgECAgEBAwIBAQIBAgEB
f a	AQIDAQECAgQuCHonAg==
 an	AQMECQ0vDQYYNAgTAggFAgoDCAY=
f t	AR8HAQIrHQUYBg0ECxMWAQICAQEBAws=
 th	ARsEBwECHA8FGAUYBg0ECw8EFhMD
the	ARkCAgIHAQIZCggFDgoFDQsGDQQLBgkEFBQBAwgB
he 	ARsEBwECGRIFDgoFDQsGDQQLBgkEKAED
e v	ATO4AQ==
 va	AT9HZQY=
val	AUWDARo=
all	AQRPO2Q=
lle	AR0MLzQUIg==
ley	AQ==
eys	AQ==
ys 	AQ==
s o	AUigAQc=
uni	AksqJh8DHQMGAwEH
nit	AkUGUEgDAQc=
ite	AiIpJBwQSAMBBw==
ted	AkcEUEgDAQc=
ed 	AkcEUEgDAQc=
d a	Al4XUg8K
 ar	AgUDfjkTIQ==
ara	Aj8BBSIfHRUHEyE=
rab	Aj9HORMh
ab 	Aj9HTA==
b e	Ag==
 em	Ag==
emi	Am8=
mir	Ag==
ira	AmkB
rat	Ah0JAxMHBBYKEAUEEgQQFxIM
ate	AhsaDAYSDBQYCg8EBwQtAQMEBA==
tes	AkdUSwEH
afg	Aw==
fgh	Aw==
gha	A08=
han	AwICSwoe
ani	AwMBPQMqFBIYCQUo
nis	A1w1SgE=
ist	AzMpGQoSHhUUAw0G
sta	AwQWARQFDAYeAgsHAhYKEwIFBAwUAwoBAgEEBA==
tan	AwQaJiILCRoVBgYPFAMHBg==
isl	AwwRAgUGCRICEAYIBAEPEwYCBAgGCAEDBwYUBgQDBQcB
sla	AwwRAgUGCRICEAYMAQ8TBgIECAYIAQMHAgQUBgQDBQcB
lam	AxlQKxs=
ami	A2gBKwkS
mic	A0YjKxs=
ic 	AwMBAQICBAECAwIBBgQBBAICAgEBAQEBAQMCAQQBAQEEAQELAwECAQICAQMBAQIEAgEBBgMDAQMBBAECAgQDAQEBAQUCAQEBAwECAgEDAQQBAwEBBgEEBQECAgMBAQEBAQEBBQEDAgICAQIBAgMBAwMBAwIBAQ==
c r	AyUWBxQTEhkRCh8M
 re	AwcJDAkBAQYIAQQBAwQGAQ0GDQIGBQUBAwwGAw0ECgYICgQDAwUECAUEAw==
rep	AwMBAQICBAECAwIBBgQBBAEBAgIBAQEBAQEDAQEBAwEBAQEEAQEEAQYDAQIBAgIBAwEBAgQCAQEBBQECAwEDAQEDAQICBAMBAQEBBQIBAQEDAQICAQMBBAEDAQEFAQEEAgMBAgICAQEBAQEBAQECAwICAgICAQIBAgMBAwMBAwIBAQ==
epu	AwMBAQICBAECAwIBBgQBBAEBAgIBAQEBAQEDAQEBAwEBAQEEAQEEAQYDAQIBAgIBAwEBAgQCAQEBBQECAwEDAQEDAQICBAMBAQEBBQIBAQEDAQICAQMBBAEDAQEFAQEEAgMBAgICAQEBAQEBAQECAwICAgICAQIBAgMBAwMBAwIBAQ==
pub	AwMBAQICBAECAwIBBgQBBAEBAgIBAQEBAQEDAQEBAwEBAQEEAQEEAQYDAQIBAgIBAwEBAgQCAQEBBQECAwEDAQEDAQICBAMBAQEBBQIBAQEDAQICAQMBBAEDAQEFAQEEAgMBAgICAQEBAQEBAQECAwICAgICAQIBAgMBAwMBAwIBAQ==
ubl	AwMBAQICBAECAwIBBgQBBAEBAgIBAQEBAQEDAQEBAwEBAQEEAQEEAQYDAQIBAgIBAwEBAgQCAQEBBQECAwEDAQEDAQICBAMBAQEBBQIBAQEDAQICAQMBBAEDAQEFAQEEAgMBAgICAQEBAQEBAQECAwICAgICAQIBAgMBAwMBAwIBAQ==
bli	AwMBAQICBAECAwIBBgQBBAEBAgIBAQEBAQEDAQEBAwEBAQEEAQEEAQYDAQIBAgIBAwEBAgQCAQEBBQECAwEDAQEDAQICBAMBAQEBBQIBAQEDAQICAQMBBAEDAQEFAQEEAgMBAgICAQEBAQEBAQECAwICAgICAQIBAgMBAwMBAwIBAQ==
lic	AwMBAQICBAECAwIBBgQBBAEBAgIBAQEBAQEDAQEBAwEBAQEEAQEEAQYDAQIBAgIBAwEBAgQCAQEBBQECAwEDAQEDAQICBAMBAQEBBQIBAQEDAQICAQMBBAEDAQEFAQEEAgMBAgICAQEBAQEBAQECAwICAgICAQEBAQIDAQMDAQMCAQE=
c o	AwMBAQICBAECAwIBBgQBBAICAgEBAQEBAQMCAQQBAQEEAQELAwECAwIBAwEBAgQCAQEGAwMBAwUBAgIEAwEBAQEFAgEBAQMBAgIBAwEEAQMBAQYBBAUBAgIDAQEBAQEBAQUEAgICAQIBAgMBAwMBAwIBAQ==
 af	AyZ3RxA=
ant	BAUViwEv
nti	BAYU
tig	BA==
igu	BJIB
gua	BFMEAToPFTA=
ua 	BKwB
a a	BAYHSYsB
nd 	BAsCDSgCBQ0GEgYOJggMBwIIAgMCAggDCAY=
d b	BA==
 ba	BA8EAwY=
bar	BA4IJokBHA==
arb	BAwC
rbu	BA==
bud	BA==
uda	BBd2Mww=
ang	BQMLZ2s=
ngu	BXU=
gui	BUsGAgUBUh8=
uil	BQ==
ill	BRkMlgE=
lla	BQhMTQ==
mal	BUMTMwMIAgECMA==
lli	BU+PARA=
lio	BcEB
iou	BZEB
ouh	BQ==
uha	BQ==
ana	BR4DFwoJAgwLLAELCwEi
alb	BsMB
lba	BsMB
ban	Bg1saw==
nia	BgEKLwQBASALFAsHCg4IAQULFgcB
 al	BhEnOQ==
shq	Bg==
hqi	Bg==
qip	Bg==
ipe	BssBEw==
per	Bg9XQg==
eri	BgUzBUAhISQH
ris	BjA8BiIt
ise	BkY=
arm	Bw==
rme	Bw==
men	Bz9OShc=
eni	BxJAbxY=
hay	Bw==
aya	B7gB
yas	B5UB
ast	BwQhOXgN
ni 	Bw==
i h	Bw==
 ha	B1w=
anr	Bw==
nra	Bw==
rap	Bw==
ape	By0=
pet	Bw==
etu	B34=
tut	Bw==
ut'	Bw==
t'y	Bw==
'yu	Bw==
yun	Bw==
ngo	CCACaQ==
gol	CIsBRg==
ola	CBNlMw==
nta	CXtUEg==
tar	CUpoHQ==
arc	Cc8B
rct	Cc8B
cti	CYQBSw==
tic	CR8WBzQFBCYpBwUP
ica	CQEBHgkKATMmBwMFQgIDBAc=
arg	Cg==
rge	Cp0B
gen	Cg==
ent	Ch+HAToDBw==
tin	CoMBCSEcAg==
ina	CgcECBMYFzUCORUC
ine	ChE7AgVTAQYtAgc=
ne 	CqcB
e r	ChUFKBMTDRUkCBk=
ca 	Cg==
ame	CySgARoH
mer	CyS6AQc=
ric	Cx4JaAYWMQIHBw==
can	CwUWAxRgED8E
an 	CxMLFC0EDAIMFRoICAIDCBgCAg==
n s	CzdbVw==
 sa	CxMkGDMHLQsFASI=
sam	C+kB
amo	C3xt
moa	C+kB
eas	C1pENA0=
ste	CwE2P1wNCg==
ter	CwEbGygpJCESCg==
ern	CzcLBBUvQxIKBAE=
rn 	CzcLSCAjEgoEAQ==
aus	DAE=
ust	DAERSw==
str	DAFSNQ==
tri	DDeEARs=
ria	DAooGh8MEg8wGg==
 au	DA==
ost	DCY3
err	DBtDBSkcAxQN
rre	DKgB
rei	DA==
eic	DA==
ich	DE4=
tra	DRwaHDU=
ral	DRwQDA5RBCY=
lia	DWElOw==
uss	DQ8ImwE=
ssi	DRcheg==
sie	Db4B
iel	DRc=
ela	DRcpGQc+DiMS
lan	DQIPAgIFBAIJAwcGAgIDBwYGBgcFCgYNBgYBBwMDAgYCAgcEAhECAQICAgQDBQcB
nov	DZ4B
ova	DX4gHw==
va 	DQ==
a h	DQ==
 ho	DRg8
hol	DZkBRg==
oll	DYABGQ==
ndi	DQs8EQQBGCk=
dia	DUcVAQshFQ==
new	DZQBCgVC
ew 	DZQBCgVC
w h	DeUB
aru	Dg4IMw==
rub	Dg==
uba	DiU=
ala	Dw0rDQczDgINDg==
d i	DzkY
 is	DxECBQYJEgIQBgcBFBMGBggGCAQHBhQGBAMFBwE=
nds	Dw8CBwYbAhAGHBMGBgsLBA0UAgQEAwUHAQ==
ahv	Dw==
hve	Dw==
ven	D7kBAiQ=
ena	Dz95Jg==
nan	D3A=
anm	Dyw/GA==
nma	DyxX
maa	D8QB
aze	EA==
zer	EBs=
erb	EK4B
rba	EAI=
bai	EEE=
aij	EJQB
ija	EHcdGgo=
jan	ELkB
 az	EA==
aza	ECVI
zar	EA==
bay	EA==
ayc	EA==
yca	EA==
bos	EQ==
osn	EQ==
sni	EQ==
ia 	ET4LUQ==
d h	Ea8B
 he	EbYBKw==
her	EQ0PICsdETIgAQ==
erz	EQ==
rze	EQ==
zeg	EQ==
ego	EQ==
gov	EQ==
ovi	Ea4B
vin	ETelAQ==
f b	EQIBAgEBAQMBAgICAQ==
 bo	EQwG
ia-	EQ==
a-h	EQ==
-he	EQ==
erc	EQ==
rce	EQ==
ceg	EQ==
bad	Eg==
ado	Ei1eNQ==
dos	Elc0
bim	Eg==
ims	Eg==
msh	Eg==
shi	Eg==
hir	EnY=
ire	EgwKBCEZ
ngl	Ezo=
gla	Ezo=
lad	E0Y=
ade	E0Q=
des	E60BMgYB
esh	Ew==
peo	Ex0OOwU=
eop	Ex0OOwU=
opl	Ex0OOwU=
ple	Ex0OOwUr
le'	Ex0OOwU=
e's	Ex0OOwU=
's 	Ex0OOwU=
s r	Ex1J
bel	FBABlAE=
elg	FA==
lgi	FA==
giu	FA==
ium	FA==
kin	FAECCgcTCQkkBA8FHQEaBBAFBg==
ing	FAMKBhQJCSQBAwUKBR0BGgQBDwUGCA==
ngd	FAMKGgkJJAQPBR0BGgQQBQY=
gdo	FAMKGgkJJAQPBR0BGgQQBQY=
dom	FAMKGgEBBwkkBA8FHQEaBBAFBg==
om 	FAMKGgkJJAQPBR0BGgQQBQY=
m o	FAMKGgkJJAQPBR0BGgQQBQY=
 be	FAUL
giq	FA==
iqu	FIIBCRUC
que	FIIBCRUC
gie	FA==
bur	FQNuDA==
urk	FcEBCAM=
rki	FcwB
na 	FXcJ
a f	FaoB
 fa	FQ==
fas	FQ==
aso	FQ==
upp	FQ==
ppe	FQ==
er 	FTUuGw==
r v	FQ==
 vo	FQ==
vol	FQ==
olt	FQ==
lta	FTENRhM=
bul	FiY=
ulg	Fg==
lga	Fg==
gar	Fk5i
ari	FggiVQE2Ig==
 bu	FgI=
bah	Fwk=
ahr	Fw==
hra	Fw==
rai	F88B
ain	FwMEJgkrCAQJJxMMEwc=
mam	Fw==
aml	Fw==
mla	Fw==
lak	Fy8=
aka	Fw==
kat	Fw==
at 	FzYcQw==
t a	F4kBDEE=
al-	F2ASOw==
l-b	Fw==
-ba	Fw==
ray	Fw==
ayn	Fw==
daw	Fw==
awl	Fw==
wla	Fw==
lat	F3A=
uru	GH8SQQ==
run	GAQ=
und	GA==
ubu	GCQ=
ben	GQ==
nin	GU8u
dah	GQ==
aho	GQ==
hom	GQ==
ome	GS1OPQ==
mey	GQ==
sai	GgRaCA0nEwwa
int	GgRaCA0nEwwa
nt 	GgRaCA0cBwQTDBoH
t b	GjM=
art	GnMJPQ==
rth	GjMsFwVj
hel	Gj9qBA==
ele	Gp8BDg==
lem	Gg==
emy	Gg==
st.	GnM=
t. 	GnM=
. b	Gg==
ths	Gg==
rts	Gg==
ber	G0sd
erm	Gx4=
rmu	Gw==
mud	Gw==
vir	G9QBAQ==
irg	G1l7AQ==
rgi	GzQLlQEB
gin	G9QBAQ==
neo	Gw==
eol	Gw==
bru	HA==
une	HG4=
nei	HA==
ei 	HA==
i d	HA==
 da	HKsB
dar	HA==
rus	HAgTiAE=
ssa	HEE=
sal	HIABNg==
nat	HAGPAQ==
ati	HAEBAQkDEwcaAxQDBQQSAhIXEgQIDw==
tio	HAEOlAE=
ion	HAEONBgdKAMHARU=
on 	HEMYHSgGBAEV
n o	HEMLDR0=
 br	HAMu
ei,	HA==
i, 	HA==
, t	HA==
e a	HJgBHQ==
 ab	HA==
abo	HBgY
bod	HFk=
ode	HNwBAQ==
de 	HHE=
e o	HAEmJAETMQQHBDk=
f p	HJEBAQICAQQCAQ==
 pe	HF0FMA==
pea	HMsB
eac	HA==
ace	HHQ=
bol	HdEB
oli	HXZb
liv	HdEB
ivi	HXA=
via	HWoEMw==
plu	HQ==
lur	HQ==
uri	HVogAzU=
ona	HQEuCgoq
nal	HUNN
al 	HQwQDBMHNRAEBSEe
l s	HXY/Gg==
 st	HRoMBkoKEwcxAQMEBA==
tat	HQEZDAYeFBgKEwcELQEDBAQ=
te 	HQcIFyQKChIfBAcEOQ==
bon	Hi5w
nai	Hi5Y
air	HgqNAQ==
re,	Hg==
e, 	Hg==
, s	Hg==
 si	HqgBBQg=
sin	HictVA0=
t e	Hg==
 eu	Hg==
eus	Hg==
tiu	Hnw=
ius	Hnw=
us 	HtIB
s a	HlpeHQ==
d s	HiuKARUBBw==
sab	Hg==
aba	HiJH
net	HogB
eth	Hidh
erl	Hg17
rla	Hg17
ds 	HiqoAQ==
til	Hg==
les	Hi83MwwWAQM=
dut	HrEBBA==
utc	HrEBBA==
tch	HrEBBA==
ch 	HhoTBQozBB4gBAU=
h a	HtcBAg==
car	HnAX
arr	Hg==
rri	HglDBUgYCQ==
rib	HlgT
ibe	Hkgd
bea	Hg==
ean	HkxF
n n	Hg==
 ne	HlouAgg=
ibb	Hg==
bbe	Hg==
bra	Hwsp
raz	HwsL
azi	H7YB
zil	H7YB
fed	HwwODARbBBcP
ede	HwwODARbAgIXBgk=
der	HwwODARbAgIXDw==
era	HwwODAQOPw4EFw8=
tiv	H0AuBw==
ive	H0A1Bw==
ve 	H0A1Bw==
ras	HwYQLA==
asi	Hw==
sil	Hw==
aha	ICIa
ham	IA==
ama	IFAHESU=
mas	IBY=
com	IBw7Hg==
omm	IBxZ
mmo	IBxZ
mon	IBxOAgcCAyo=
onw	IBxZ
nwe	IBxZ
wea	IBxZ
eal	IBxZFg==
alt	IBwKDUIE
lth	IBxZ
th 	IBweHwEWBQswJQI=
h o	IBxZGg==
e b	IA==
ma 	IFc=
a i	IHVL
bhu	IQ==
hut	IQ==
uta	IXY=
 bh	IQ==
dru	IQ==
ruk	ITY=
uk 	IQ==
k y	IQ==
 yu	IQ==
yul	IQ==
bou	IhhMNg==
ouv	In8=
uve	In8=
vet	Ig==
et 	Ip0BMg==
t i	IkNE
bot	Iw==
ots	Iw==
tsw	Iw==
swa	I7IB
wan	I11AJA==
lar	JA==
bye	JA==
yel	JA==
elo	JDNd
lor	JA==
oru	JA==
sia	JCUcBzIREBsFGQE=
bie	JA==
whi	JA==
hit	JA==
 ru	JA==
eli	JQI=
liz	JQ==
ize	JQ==
bri	JSgRDIUBAw==
rit	JQIcChEMLAEDHSEX
iti	JSIXBQcsBFU=
tis	JTkMhQE=
ish	JTkMhQE=
sh 	JTkMhQE=
h h	JQ==
hon	JQsvAhE=
ond	JTw=
ndu	JTwI
dur	JTw=
ura	JRAs
nad	JiifAQ==
ada	JigJAjU=
coc	Jw==
oco	Jw==
cos	JwukAQ==
os 	J3Y5
s (	JyE=
 (k	JwE=
(ke	Jw==
kee	Jw==
eel	J4QB
lin	Jw==
ng)	Jw==
g) 	Jw==
) i	Jw==
ito	J0NNIQ==
tor	JzESTSE=
ory	JwU+TQ==
ry 	JwWnAQ==
e c	JwECTQ==
 co	JwECAQEFAUU=
ng 	JzgTdg==
g i	J8EB
s i	Jw8SjgE=
dem	KBYHNAUEJikM
emo	KBYHNAUEJikM
moc	KBYHNAUEHQkpDA==
ocr	KBYHNAUEJikM
cra	KBYHNAUEJikM
con	KAIBKw==
ong	KAIGLzRN
drc	KA==
go-	KAI=
o-k	KA==
-ki	KA==
ins	KA==
nsh	KA==
sha	KGc=
has	KEk=
asa	KA0RVg0=
dr 	KA==
r c	KA==
zai	KA==
go 	KAI=
o (	KAI=
(ki	KA==
sa)	KA==
cen	KZ4BJg==
ntr	KSaEAQ==
l a	KTY1
afr	KXdHEA==
fri	KXdABxA=
n r	KRQxfAQKAQ==
o-b	Kg==
-br	Kg==
azz	Kg==
zza	Kg==
zav	Kg==
avi	KmEz
vil	Kg==
o r	KowB
 (b	Kg==
(br	Kg==
le)	Kg==
swi	Kw==
wit	Kw==
itz	Kw==
tze	Kw==
wis	Kw==
iss	KzI=
ss 	Kw==
s c	Kw==
onf	Kw==
nfe	Kw==
sui	Kw==
uis	Kw==
sse	Kw==
sch	Kw4=
chw	Kw==
hwe	Kw==
wei	Kw==
eiz	Kw==
svi	K8UB
viz	Kw==
izz	Kw==
zze	Kw==
izr	Kw==
zra	Kw==
cot	LCE=
ote	LH8=
e d	LGE=
 d'	LA==
d'i	LA==
'iv	LA==
ivo	LA==
voi	LA==
oir	LA==
f c	LAIBAQEBAQEDKAMTH0MN
vor	LA==
y c	LA==
coa	LAk=
oas	LA==
te-	LA==
e-d	LA==
-d'	LA==
d'l	LA==
'lv	LA==
lvo	LA==
coo	LQ==
ook	LQ==
ok 	LQ==
k i	LXY=
erv	LQ==
rve	LQ==
vey	LQ==
ey 	LQ==
y i	LbMB
k g	LQ==
 gr	LSCgAQ==
gro	LSc4
rou	LZAB
oup	LSo=
chi	LgIIJxYfUA==
hil	LoMBDw==
ile	LqwB
 ch	LgIvGRxDDQ==
cam	L0Yq
ero	L3o=
roo	Lw==
oon	Lw==
 ca	LwVBLDU=
hin	MC8KK1A=
zho	MA==
ngg	MA==
ggu	MA==
guo	MA==
col	MVw=
olo	MZEB
lom	MZEB
omb	MQ==
mbi	MSRKWQ==
bia	MSRLHgM0Aw==
ta 	Mg==
a r	Mg==
 ri	MkBE
cub	Mw==
 cu	M5QB
cab	NA==
bo 	NA==
o v	NBNA
 ve	NLoB
ver	NJEB
erd	NA==
rde	ND1V
cap	NA==
pe 	NA==
cur	NQ==
rac	NQ==
aca	NV8C
cao	NV8=
kor	NUQB
ors	NS8=
rso	NQ==
sou	NSUgJjAIHQIC
uro	NQ==
roc	NVRb
oca	NWo=
sao	NZwB
zao	NQ==
aco	NVU=
cau	NV8=
chr	NkI=
hri	NkI=
stm	Ng==
tma	Ng==
as 	NhI=
cyp	Nw==
ypr	Nw==
pru	Nw==
 cy	Nw==
gre	NxYBBgWUAQ==
ree	Nx0F
eek	Nw==
ek 	Nw==
k c	Nw==
rio	Nw==
iot	Nw==
ot 	Nw==
t s	N3lE
cze	OA==
zec	OA==
ech	OEk=
hia	OD0=
h r	OBM=
ger	OQVkAg==
rma	OVk=
man	OS8UMBE=
any	OV5O
l r	OWsq
f g	ORQEAQQFAgE=
 ge	OSE=
deu	OQ==
eut	OQ==
uts	OQ==
tsc	OQ==
chl	OQ==
hla	OQ==
dji	Og==
jib	Og==
ibo	Og==
out	OiAgGQ0wCBANAgI=
uti	Og==
f d	OgEB
 dj	Og==
ibu	Og==
but	Og==
gab	OhI=
abu	Og==
buu	Og==
uut	Og==
jab	Og==
den	OzY1ChUBLg==
enm	Ow==
mar	OzwSBAIDAwE2Bw==
ark	Ow==
 de	OwMHOQ8b
dan	OzYgMww=
omi	PAEJ
min	PAEiGxpU
ini	PAEIGjUCIR4NBA==
nic	PAEcPQ8=
 do	PA==
wai	PD8=
ai'	PA==
i't	PA==
'tu	PA==
tu 	PAs=
u k	PA==
 ku	PD8=
kub	PA==
uli	PA==
alg	Pg==
lge	Pg==
s d	PkA=
ecu	Pw==
cua	Pw==
uad	Pxg=
f e	PwEBAgITegM=
 ec	Pw==
est	QAJbAxcmFw==
sto	QDg=
ton	QKAB
oni	QFAR
 es	QJUB
ees	QA==
sti	QHc=
ti 	QA==
i v	QA==
vab	QEc=
rii	QA==
iik	QA==
stl	QA==
tla	QA0=
egy	QQ==
gyp	QQ==
ypt	QQ==
b r	QZMB
 eg	QQ==
mis	QQ==
isr	QSY=
wes	Ql41Hw==
sah	Qg==
har	Qic=
itr	Qw==
tre	Qw==
rea	QwosAQ==
e s	QxczKg0=
 er	Qw==
iri	QzMS
riy	Q0U=
iya	Q0U3
ert	Q3M=
rtr	Qw==
spa	RA==
pai	RA==
f s	RD4LMQMCAgECAwEBAQEBAQIHGgM=
 sp	RBs1
his	RA==
isp	RA==
pan	RC47
thi	RQ==
hio	RQ==
iop	RQ==
opi	RQ==
pia	RQ==
l d	RWM=
 et	RQ==
aby	RQ==
bys	RQ==
yss	RQ==
fin	Rg==
inl	Rg==
nla	Rg4=
f f	RgE=
 fi	RgE=
suo	Rg==
uom	Rg==
en 	RoABDQ==
n t	RiRNIQ==
 ta	RpUBCQE=
tas	Rg==
sav	Rg==
ava	Rg==
d o	Riw6FBo=
 a 	Rno=
a t	Rno=
tho	Rj48
hou	Rno=
ous	Rno=
usa	Rno=
san	RhRPFww=
d l	Rg==
 la	RjwFORg=
ake	Rg==
kes	Rg==
inn	Rg==
nni	RiI=
fij	Rw==
iji	Rw==
mat	R08=
ata	RyJS
itu	Rw==
u t	Rw==
 tu	R5gBAg==
tug	R3E=
uga	R3Ev
gal	R3EV
lal	Rw==
la 	Rw==
a o	R6MB
 o 	Rw==
 vi	R6YBAgEB
vit	R0Y=
ji 	Rw==
i g	Rw==
 ga	Rw4U
gan	RyIuTgI=
nar	RyI=
raj	RyI=
ajy	RyI=
jya	RyI=
fal	SA==
alk	SA==
lkl	SA==
kla	SA==
 (m	SA==
(ma	SA==
alv	SIoB
lvi	SA==
nas	SE0=
as)	SA==
las	SBE=
s m	SFVL
 ma	SCAlAQEBAQQCAgEBAS0DBw==
icr	SQ==
cro	SRk=
ron	SQ==
one	SQMZSB4=
nes	SQMZGjACMwk=
esi	SRxKSQE=
es 	SZ8BAQc=
f m	SR8hAQEDAwEFAgEBAQM=
 mi	STE6NA==
far	Sg==
aro	SholIg==
roe	Sgo=
oe 	Sg==
e i	Sh4zFjI=
fae	Sg==
aer	Skw=
r o	Sp4B
 oe	Sg==
oer	Sl8=
oes	Sg==
she	Sic=
hee	Sg==
eep	Sg==
ep 	Sg==
p i	Sg==
fra	S0I=
ran	SyEaBw==
anc	S0I=
nce	S0Jg
fre	SwU9BB4p
ren	SwMCMgsEHikV
enc	SwU9BB4p
nch	SwU9BB4p
ese	TDM5CBkL
se 	TDM5CBkL
ais	TA==
d k	TQ==
 ki	TSQFAgw=
eat	TQ==
ita	TSEpIQ==
tai	TTdg
in 	TTcJRhwB
n a	TTs/DQQ=
d n	TSs=
 no	TUMFEgQ=
nor	TSwHEAUOBEEQ
ort	TSwXBSECQA==
n i	TS85BwYaEwE=
 ir	TR4B
rel	TRk=
uk	TQ==
eng	TQ==
sco	TQ==
otl	TQ==
wal	TaYB
ale	TVQW
geo	Tws=
eor	Tws=
org	TwtN
gia	Tws=
a (	Tw==
 (c	Tw==
(co	Tw==
cou	T4QB
oun	TzUSPQ==
unt	TzVP
try	T4QB
ry)	Tw==
h g	UAoEcQ==
 gu	UAEFAgMCAVIf
uia	UA5x
ian	UA4MBCcBIQgQBRo=
guy	UA4=
uya	UA4=
yan	UA4qCg==
ane	UC8Y
gue	UWc=
uer	UWU=
rns	UQ==
nse	UQ==
sey	UR5U
ail	UYkB
ili	UWA=
liw	UQ==
iwi	UQ==
wic	UQk=
ick	UQ==
ck 	UQ==
k o	UQ==
 gh	Ug==
gib	Uw==
ibr	Uw==
een	VA==
enl	VA==
kal	VA==
laa	VA==
aal	VA==
it 	VA==
t n	VJ0B
 nu	VA==
nun	VA==
una	VEJd
naa	VEM=
aat	VA==
oen	VA==
gam	VQ==
amb	VSAqWQ==
e g	VZgB
uin	VgIFUw==
nea	VgIFUw==
ea-	Vgc=
a-c	Vg==
-co	Vg==
nak	Vks=
akr	Vg==
kry	Vg==
del	Vw==
lou	Vw==
upe	Vw==
kar	Vzc=
uke	Vw==
ker	Vw==
gwa	Vw==
wad	Vw==
adl	Vw==
dlo	Vw==
equ	WA==
qua	WA==
uat	WAOXAQ==
ato	WA==
ori	WB8gAxwiEg==
ial	WAcjEl0=
l g	WA==
 eq	WA==
eec	WQ==
ece	WQ==
ell	WUgiIA==
len	WW4=
uth	WiAmMAgdAgI=
d t	Wm0bCw==
 so	WihMAggf
h s	Wjc/AwU=
ndw	Wg==
dwi	Wg==
h i	WhA=
tem	Ww==
ema	Ww==
uam	XA==
uah	XA==
a-b	XQ==
-bi	XQ==
bis	XQ==
sau	XWQ=
g k	Xw==
 ko	XxgCAQ==
kon	Xw==
g s	XxM=
spe	XzU=
pec	XzU=
eci	XzU=
cia	XyECEl0=
 ad	XzU=
adm	XzU=
dmi	XzU=
reg	XzU=
egi	XzU=
gio	XxIj
hks	Xw==
ksa	Xw==
sar	XzU=
hea	YBU=
ear	YEs8
ard	YBFVAw==
rd 	YGk=
d m	YD0X
 mc	YA==
mcd	YA==
cdo	YA==
don	YAUrEQ==
ald	YDs=
ld 	YA==
f h	YQI=
roa	Ykk=
oat	Yg==
tia	Yg==
 cr	Yg==
hai	Y3c=
ait	Yxg=
ayi	Yw==
yit	Yw==
hun	ZA==
ung	ZA==
nga	ZGIaBQ==
ary	ZA==
mag	ZCU=
agy	ZA==
gya	ZA==
yar	ZA0=
ror	ZA==
rsz	ZA==
sza	ZA==
zag	ZA==
ind	ZQQBRkQ=
f i	ZQICAgEB
 in	ZQQB
st 	ZR0LEz0U
die	ZQ==
ies	ZXM=
hib	Zg==
rni	Zg==
eir	Zg==
sra	Zw==
rae	Zw==
ael	Zw==
sle	aA==
le 	aA==
ann	aC8=
i. 	aA==
. m	aCU=
 m.	aA==
anx	aA==
bha	aQ==
t g	aQ==
atv	aR4=
tva	aQ==
var	aYUB
ars	aSY=
rsh	aSY=
doo	aQ==
oos	aQ==
dus	aQ==
 oc	akU=
oce	akU=
cea	akU=
 te	ak0h
raq	aw==
mes	aw==
eso	axk=
sop	aw==
opo	aw==
pot	aw==
ota	aw==
tam	aw==
mia	aw==
ers	bAM=
rsi	bA==
ice	bS1J
cel	bQ==
 ic	bQ==
ysl	bQ==
tal	bnw=
aly	bg==
jer	bw==
rse	bw==
ier	b0UX
jam	cBg=
mai	cA==
aic	cGY=
jor	cQ==
ord	cQ==
rda	cQ==
ash	cQ==
hem	cQ==
mit	cQ==
e k	cQ==
f j	cQ==
 jo	cQ==
ior	cQ==
jap	cg==
apa	cno=
isi	cm0=
 su	ch8zCwE=
sun	cg==
nip	cg==
ipp	cj8=
ppo	cg==
pon	cg==
on-	cg==
n-k	cg==
-ko	cg==
kok	cg==
oku	cg==
nih	cg==
iho	cg==
ken	c0M=
eny	cw==
nya	cyQF
f k	cwMDAQEC
 ke	cw==
kyr	dA==
yrg	dA==
rgy	dA==
gyz	dA==
yzs	dA==
zst	dA==
yz 	dA==
z r	dA==
kir	dAI=
rgh	dA==
ghi	dA==
hiz	dA==
izi	dA==
zia	dA==
mbo	dRE=
odi	dQ==
kam	dQ==
amp	dQ==
mpu	dQ==
puc	dQ==
uch	dRE=
che	dU4=
odz	dQ==
dzh	dQ==
zha	dQ==
boy	dQ==
oya	dQ==
boj	dQ==
oja	dQ==
iba	dm8=
bat	dg==
omo	d0s=
mor	dxIOA0M=
oro	dxI=
ros	d0g=
nio	d0UDHQ==
udz	dw==
dzi	dw==
zim	d4IB
ima	dw==
a w	dw==
 wa	dw==
wa 	dw==
a k	dw==
kom	dw==
wak	dw==
aku	dw==
ku-	dw==
u-m	dw==
-mo	dw==
juz	dw==
uzu	dw==
zur	dw==
ur 	dw==
r a	dwE=
l-q	dw==
-qu	dw==
qum	dw==
umu	dw==
mur	dyA=
-qa	dw==
qam	dw==
l-i	dw==
-it	dw==
itt	dwE=
tti	dw==
tih	dw==
iha	dw==
had	d2A=
ad 	d2s=
t k	eA==
kit	eA==
tts	eA==
ts 	eA==
nev	eA==
evi	eA==
vis	eA==
t c	eA==
top	eA==
oph	eA==
phe	eA==
s &	eA==
 & 	eA==
& n	eA==
h k	eQE=
ore	eQFM
c p	eQ==
dpr	eQ==
prk	eQ==
jos	eQ==
ose	eQ==
seo	eQ==
eon	eVI=
cho	eQE=
hos	eQE=
oso	eQE=
son	eQE=
dae	eg==
aeh	eg==
eha	eg==
nmi	eg==
guk	eg==
n m	ehs0Aw==
kuw	ew==
uwa	ew==
cay	fA==
aym	fA==
yma	fA==
ans	fHs=
kaz	fQ==
zak	fQ==
akh	fQ==
khs	fQ==
hst	fQ==
 ka	fQ==
qaz	fQ==
zaq	fQ==
aqs	fQ==
qst	fQ==
lao	fg==
aos	fg==
ao 	fhY9
o p	fg==
lpd	fg==
pdr	fg==
leb	fw==
eba	fw==
ano	fwEd
non	fw==
lub	fw==
ubn	fw==
bna	fw==
t l	gAE=
 lu	gAEG
luc	gAE=
uci	gAE=
iyo	gAE=
yon	gAE=
ono	gAE=
nol	gAE=
hew	gAE=
ewa	gAE=
lie	gQEE
iec	gQE=
cht	gQE=
hte	gQE=
ten	gQELRw==
ens	gQFGAw==
nst	gQE=
tei	gQE=
ein	gQE=
f l	gQECAQEBAQ==
 li	gQECAg==
sri	ggE=
ri 	ggE=
i l	ggE=
ank	ggE=
nka	ggE=
c s	ggE=
soc	ggFv
oci	ggFv
lis	ggFvAg==
t r	ggFv
 sr	ggE=
ser	ggEWJg==
ere	ggE=
end	ggEuMBQ=
dib	ggE=
cey	ggE=
eyl	ggE=
ylo	ggE=
lon	ggEy
lib	gwEF
sot	hAE=
oth	hAE=
 le	hAFHEg==
e m	hAEL
 mo	hAEFAQEIDA==
mou	hAE=
n k	hAE=
ith	hQE=
thu	hQE=
hua	hQE=
uan	hQERTg==
iet	hQE6Mg==
tuv	hQFe
uva	hQFe
lux	hgE=
uxe	hgE=
xem	hgE=
emb	hgE=
our	hgE2
urg	hgE=
gra	hgE=
d d	hgE=
 du	hgE=
duc	hgE=
chy	hgE=
hy 	hgE=
mbu	hgFP
tvi	hwE=
let	hwE=
etm	hwE=
tmo	hwE=
mo 	hwE=
bam	hwE=
vij	hwE=
tve	hwE=
vej	hwE=
eja	hwE=
iby	iAE=
bya	iAE=
b j	iAE=
 ja	iAFB
mah	iAE=
ahi	iAE=
occ	iQE=
cco	iQE=
lma	iQE=
agr	iQE=
gri	iQE=
l-m	iQE=
-ma	iQEE
nac	igEM
mun	igE=
neg	igECQQ==
egu	igE=
mol	iwE=
old	iwE=
ldo	iwE=
dov	iwE=
lda	iwE=
dav	iwE=
ont	jAEM
nte	jAE=
ene	jAFBIQ==
egr	jAE=
crn	jAE=
rna	jAE=
a g	jAE=
 go	jAE=
gor	jAE=
ora	jAE=
nt-	jQE=
t-m	jQE=
rti	jQEJPQ==
lec	jQE=
ect	jQE=
t m	jQFG
n (	jQFG
 (f	jQE=
(fr	jQE=
h p	jQEiJA==
 pa	jQEgAwIFAgEZ
par	jQEtGQ==
rt)	jQFG
ce)	jQE=
mad	jgEI
dag	jgE=
aga	jgEJ
gas	jgE=
asc	jgE5
sca	jgEe
lag	jgE=
ask	jgE=
ska	jgElDA==
asy	jgE=
sy 	jgE=
y r	jgE=
hal	jwE=
ll 	jwE=
l i	jwE=
h m	kAE=
mac	kAEE
ced	kAE=
edo	kAER
f n	kAEQBAECAQE=
sud	kQEzDA==
mya	kgE=
 my	kgE=
urm	kgE=
ute	kwE=
r m	kwE=
ol 	kwE=
o s	lAE=
au 	lAE=
u s	lAE=
aom	lAE=
e n	lQENBA==
niq	lgE=
cae	lgE=
ino	lgE2HA==
adi	lgFX
din	lgFX
jou	lgE=
oua	lgE=
nik	lgE=
iki	lgFF
mau	lwED
aur	lwEDDw==
rut	lwE=
taa	lwE=
aan	lwE=
ure	lwE=
ret	lwE=
eta	lwE=
nna	lwE=
aar	lwE8
gaw	lwE=
awe	lwE=
wej	lwE=
nts	mAE=
tse	mAE=
ldi	mwE=
div	mwE=
ves	mwE=
law	nAE=
awi	nAE=
mex	nQE=
exi	nQE=
xic	nQE=
ico	nQEZIA==
 me	nQE=
tad	nQE=
s u	nQE=
 un	nQEiMQ==
nid	nQFF
ido	nQE=
nos	nQE=
lay	ngE=
ays	ngE=
ysi	ngE=
moz	nwE=
oza	nwE=
zam	nwFZ
biq	nwE=
nam	oAENIiI=
mib	oAE=
ibi	oAE=
 na	oAEJSA==
h w	oAE=
 we	oAE1
w c	oQE=
cal	oQE=
led	oQE=
nou	oQE=
vel	oQE=
le-	oQE=
e-c	oQE=
-ca	oQE=
nie	oQE=
kan	oQE=
aky	oQE=
nig	ogEC
ige	ogECIQ==
 ni	ogECAQ==
orf	owE=
rfo	owE=
fol	owE=
olk	owE=
lk 	owE=
rag	pQEV
agu	pQEV
ned	pgE=
nde	pgEKEDQ=
orw	pwE=
rwa	pwEZ
way	pwE=
nep	qAE=
epa	qAE=
nau	qQE=
nao	qQE=
aoe	qQE=
lea	qQE=
niu	qgE=
iue	qgE=
w z	qwE=
 ze	qwE=
zea	qwE=
aot	qwE=
tea	qwE=
a n	qwEF
zee	qwE=
oma	rAEREQ==
sul	rAE=
ult	rAE=
f o	rAE=
 om	rAE=
uma	rAER
mus	rAE=
usc	rAE=
cat	rAE=
l z	rQE=
 zo	rQE=
zon	rQE=
eru	rgE=
 po	rwEE
pol	rwEE
oly	rwE9
lyn	rwE=
yne	rwE=
pap	sAE8
apu	sAE=
pua	sAE=
w g	sAE=
dep	sAFE
epe	sAFE
pen	sAFE
phi	sQE=
lip	sQE=
ppi	sQE=
pin	sQE=
e p	sQE=
 ph	sQE=
pak	sgE=
aki	sgEY
kis	sgEpEA==
ols	swE=
lsk	swE=
t p	tAE=
 pi	tAE=
pie	tAE=
re 	tAE=
miq	tAE=
uel	tAE6
pit	tQE=
itc	tQE=
tca	tQE=
cai	tQEh
irn	tQE=
pue	tgE=
rto	tgE=
to 	tgE=
bor	tgE=
riq	tgE=
uen	tgE=
rik	tgE=
ike	tgE=
por	tgECDg==
inq	tgE=
nqu	tgE=
rtu	uAE=
ugu	uAEy
ues	uAE=
lus	uAE=
usi	uAE=
sit	uAE=
lau	uQEj
pel	uQE=
lew	uQE=
uay	ugEw
qat	uwE=
f q	uwE=
 qa	uwE=
reu	vAE=
eun	vAE=
urb	vAE=
rbo	vAE=
rom	vQE=
rum	vQE=
oum	vQE=
rbi	vgE=
 se	vgEFCh8=
yug	vgE=
ugo	vgE=
gos	vgE=
osl	vgE=
lav	vgE=
srb	vgE=
bij	vgE=
n f	vwE=
 fe	vwE=
ssr	vwE=
sov	vwE=
vie	vwEy
t u	vwE=
oss	vwE=
siy	vwE=
iys	vwE=
ysk	vwE=
kay	vwE=
ya 	vwE=
ats	vwE=
tsi	vwE=
nda	wAEnAw==
e l	wAE=
 hi	wAE=
lls	wAE=
aud	wQE=
udi	wQE=
di 	wQE=
i a	wQE=
abi	wQE0
sol	wgE=
eyc	wwE=
ych	wwE=
as-	xAE=
s-s	xAE=
-su	xAE=
l-s	xAE=
swe	xQE=
wed	xQE=
 sw	xQE=
sve	xQE=
rig	xQE=
gap	xgE=
apo	xgE=
n c	xgEm
 ci	xgEm
cit	xgEm
t h	xwE=
na,	xwE=
a, 	xwE=
, a	xwE=
 as	xwE=
sce	xwE=
nsi	xwEw
sio	xwE=
 tr	xwEb
n d	xwE=
da 	xwEj
a c	xwE=
cun	xwE=
unh	xwE=
nha	xwE=
slo	yAEC
lov	yAEC
ove	yAEC
 sl	yAE=
nij	yAE=
sva	yQE=
d j	yQE=
may	yQEt
aye	yQE=
yen	yQE=
vak	ygE=
kia	ygE=
ak 	ygE=
k r	ygE=
nsk	ygE=
sko	ygE=
ra 	ywE=
a l	ywE=
leo	ywE=
sen	zQE=
ega	zQE=
som	zgE=
li 	zgE=
i r	zgE=
sur	zwEF
urr	zwE=
o t	0QE=
 to	0QEPAg==
tom	0QE=
me 	0QE=
d p	0QE=
 pr	0QE=
el 	0gE=
lva	0gE=
vad	0gE=
 el	0gE=
rte	0wE=
 (d	0wE=
(du	0wE=
syr	1AE=
yri	1AE=
ury	1AE=
rya	1AE=
esw	1QE=
wat	1QE=
waz	1QE=
ila	1QEF
umb	1QE=
bus	1QE=
uso	1QE=
so 	1QE=
o w	1QE=
tur	1gEIAw==
rks	1gE=
ks 	1gE=
d c	1gE=
cha	1wE=
rie	2AEICg==
c l	2AE=
tog	2QE=
ogo	2QE=
ole	2QE=
tha	2gE=
 sm	2gE=
smi	2gE=
mil	2gE=
iam	2gE=
taj	2wE=
aji	2wE=
jik	2wE=
tok	3AE=
oke	3AE=
kel	3AE=
tim	3QE=
imo	3QE=
or-	3QE=
r-l	3QE=
-le	3QE=
 ti	3QE=
t t	3QE=
or 	3QEL
r l	3QE=
rkm	3gE=
kme	3gE=
tun	3wEU
ien	4AEK
ndl	4AE=
dly	4AE=
ly 	4AEM
ga 	4AE=
kiy	4QE=
iye	4QE=
rke	4QE=
key	4QE=
ida	4gE=
dad	4gE=
tob	4gE=
oba	4gE=
bag	4gE=
ago	4gE=
alu	4wE=
ce 	4wE=
aiw	5AE=
iwa	5AE=
ai-	5AE=
i-u	5AE=
-ua	5AE=
i-o	5AE=
-oa	5AE=
oan	5AE=
for	5AE=
orm	5AE=
rmo	5AE=
mos	5AE=
osa	5AE=
e t	5AE=
aip	5AE=
pei	5AE=
anz	5QE=
nza	5QE=
zan	5QES
d r	5QE=
nyi	5QE=
yik	5QE=
ika	5QE=
ka 	5QE=
d z	5QE=
 za	5QET
nzi	5QE=
zib	5QE=
ukr	5gE=
kra	5gE=
f u	5wEDAQ==
 ug	5wE=
oug	5wE=
arl	5wE=
rl 	5wE=
l o	5wE=
 ou	6AE=
utl	6AE=
tly	6AE=
lyi	6AE=
yin	6AE=
usm	6AE=
smo	6AE=
moi	6AE=
 am	6QE=
rug	6gE=
 ur	6gE=
 or	6gE=
uzb	6wE=
zbe	6wE=
bek	6wE=
eki	6wE=
 uz	6wE=
y s	7AE=
see	7AE=
vat	7AE=
t v	7QE=
nez	7gE=
ezu	7gE=
zue	7gE=
iva	7gE=
f v	7gEDAQ==
h v	7wE=
u.s	8AE=
.s.	8AE=
s. 	8AE=
. v	8AE=
e u	8AE=
s v	8AE=
usv	8AE=
n v	8AE=
etn	8QE=
tna	8QE=
van	8gE=
anu	8gE=
nua	8gE=
atu	8gE=
heb	8gE=
ebr	8gE=
rid	8gE=
ide	8gE=
is 	8wE=
d f	8wE=
 fu	8wE=
fut	8wE=
utu	8wE=
yem	9QE=
eme	9QE=
f y	9QE=
 ye	9QE=
ayo	9gE=
yot	9gE=
ott	9gE=
tte	9gE=
mza	9wE=
f z	+AEB
 rh	+AEB
rho	+AEB
hod	+AEB
imb	+QE=
mba	+QE=
bab	+QE=
abw	+QE=
bwe	+QE=
 zi	+QE=
