name
principality of the valleys of andorra|andorra|principality of andorra
united arab emirates|emirates
afghanistan|islamic republic of afghanistan
antigua and barbuda
malliouhana|anguilla
republic of albania|shqiperise|albania
republic of armenia|hayastani hanrapetut'yun|armenia|hayastan
angola|republic of angola
antarctica
republica argentina|argentina|republic of argentina|argentine republic
american samoa|eastern samoa
republic of austria|osterreich|austria
aussieland|new holland|nova hollandia|australia
aruba
aland islands|aland|ahvenanmaa
azerbaijan|republic of azerbaijan|azarbaycan
republic of bosnia and herzegovina|bosnia and herzegovina|bosnia and hercegovina|bosnia|bosnia-herzegovina
barbados|bimshire
bangla|people's republic of bangladesh|bangladesh
belgique|kingdom of belgium|belgie|belgium
burkina faso|upper volta
bulgaria|republic of bulgaria
bahrain|kingdom of bahrain|dawlat al-bahrain|mamlakat al-bahrayn
uburundi|burundi|republic of burundi
republic of benin|benin|dahomey
st. barthelemy|saint barthelemy|st. barths|st. barth|st. barts
bermuda|virgineola
nation of brunei, the abode of peace|brunei|brunei darussalam
bolivia|plurinational state of bolivia
caribbean netherlands|bonaire|bonaire, sint eustatius and saba|carribean netherlands|bonaire, saint eustatius and saba|netherlands antilles|dutch antilles
federative republic of brazil|brazil|brasil
bahamas|commonwealth of the bahamas|bahama islands|the bahamas
bhutan|druk yul|kingdom of bhutan
bouvet island
republic of botswana|botswana
belarus|republic of belarus|byelorussia|bielorussia|byeloruss|white russia|belorussia|bielarus
british honduras|belize
canada
territory of the cocos (keeling) islands|cocos (keeling) islands|keeling islands|cocos islands
democratic republic of the congo|congo (kinshasa)|congo|congo-kinshasa|dr congo|drc|zaire
central africa|central african republic
republic of the congo|congo (brazzaville)|congo|congo-brazzaville|congo republic
svizzera|svizra|switzerland|suisse|schweiz|swiss|swiss confederation
ivory coast|cote-d'ivoire|republic of cote d'ivoire|cote d'lvoire|cote d'ivoire
cook islands|cook group|hervey islands
chile|republic of chile
cameroon|republic of cameroon
china|people's republic of china|zhongguo
republic of colombia|colombia
costa rica|republic of costa rica
republic of cuba|cuba
cabo verde|republic of cabo verde|cape verde
korsou|curacoa|curacao|curazao|curacau|curocao|curasao
christmas island
republic of cyprus|greek cypriot state|cyprus
czech republic|czechia
federal republic of germany|germany|deutschland
gabuuti|jibuti|republic of djibouti|djibouti|jabuuti
denmark|kingdom of denmark|danmark
commonwealth of dominica|dominica|wai'tu kubuli
dominicana|dominican republic
people's democratic republic of algeria|algeria
republic of ecuador|ecuador
eesti vabariik|estonia|republic of estonia|estland
egypt|misr|arab republic of egypt
western sahara
ertra|eritrea|iritriya|the state of eritrea
kingdom of spain|hispania|spain
ethiopia|federal democratic republic of ethiopia|abyssinia
finland|republic of finland|land of a thousand lakes|suomi|finnia|suomen tasavalta
republic of fiji|fiji ganarajya|fiji|matanitu tugalala o viti
islas malvinas|falklands|falkland islands (malvinas)|falkland islands|malvinas islands
federated states of micronesia|micronesia
faroes|faer oer|sheep islands|faroe islands
french republic|france
gabonaise|gabon|gabonese republic
england|united kingdom|northern ireland|uk|united kingdom of great britain and northern ireland|scotland|britain|wales|great britain
grenada
georgia|georgia (country)
french guiana|guyane
bailiwick of guernsey|guernsey
ghana|republic of ghana
gibraltar
kalaallit nunaat|greenlandia|greenland|groenland
gambia|republic of the gambia|the gambia
guinea-conakry|republic of guinea|guinea
gwadloup|karukera|guadeloupe|gwada
equatorial guinea|republic of equatorial guinea
hellenic republic|ellada|greece|hellas
south georgia and the south sandwich islands
republic of guatemala|guatemala
guam|guahan
republic of guinea-bissau|guinea-bissau
british guiana|guyana|republic of guyana
hong kong special administrative region of china|hksar|hong kong
heard island and mcdonald islands
republic of honduras|honduras
republic of croatia|croatia
republic of haiti|haiti|ayiti
magyarorszag|hungary
republic of indonesia|indonesia|east indies
ireland|hibernia|eire
israel|state of israel
i. man|i. mannin|i. m.|mann|the isle of man|i. mann|isle of mann|manx|isle of man
bharat|indostan|bharatvarsh|republic of india|hindoostan|hindustan|bharata|india|bharat ganarajya
british indian ocean territory
mesopotamia|iraq|republic of iraq
islamic republic of iran|persia|iran
republic of iceland|ysland|iceland|island
italy|italia|italian republic
jerri|jersey|iersey
jamaica
jordan|yarden|hashemite kingdom of jordan|giordania
nihon|land of the rising sun|nihon-koku|nippon|nippon-koku|japan
republic of kenya|kenya
kirghizia|kyrgyzstan|kyrgyz republic|kyrgyz
camboya|kambodzha|kampuchea|kingdom of cambodia|campuchia|cambodia|kamboja
republic of kiribati|kiribati
comoros|juzur al-qamar|union of the comoros|waku-moria|al-ittihad al-qumuri|juzur al-qumur|udzima wa komori
saint kitts and nevis|kitts & nevis|saint christopher and nevis
choson|dprk|joseon|democratic people's republic of korea|north korea
daehanminguk|choson|daehan minguk|south korea|hanguk|republic of korea
state of kuwait|kuwait
cayman islands|caymans
qazaqstan|republic of kazakhstan|kazakhstan
lpdr|lao people's democratic republic|laos
lebanon|lubnan|lebanese republic
saint lucia|hewanorra|iyonola
liechtenstein|principality of liechtenstein
sri lanka|ceylon|democratic socialist republic of sri lanka|serendib
republic of liberia|liberia
kingdom of lesotho|lesotho|the mountain kingdom
lithuania|republic of lithuania|lietuva
luxemburg|grand duchy of luxembourg|luxembourg
republic of latvia|latvija|latveja|latvia|letmo vabamo|letmo
libya|libyan arab jamahiriya
maroc|lmagrib|kingdom of morocco|morocco|marocco|al-magrib
principality of monaco|munegu|monaco
moldavia|moldova|republic of moldova
crna gora|montenegro
collectivity of saint martin|collectivite de saint-martin|st. martin (french part)|st martin|saint martin (french part)|saint martin (france)|saint martin|st. martin|saint-martin
republic of madagascar|malagaskar|malagasy republic|malagascar|madagascar
marshall islands|republic of the marshall islands
macedonia|north macedonia|republic of north macedonia
mali|french sudan|republic of mali
burma|republic of myanmar|myanmar
outer mongolia|mongolia|mongol state
macau|macau sar|aomen|macao|macao special administrative region of china|macao sar
northern marianas|northern mariana islands|commonwealth of the northern mariana islands
madinina|iguanacaera|jouanacaera|martinique|martinica|matinino|iounacaera|madiana|maritiniki
muritanya|mauritania|mauretania|agawej|murutaane|islamic republic of mauritania|gannaar|moritani
montserrat
republic of malta|malta
mauritius|republic of mauritius|maurice|moris
republic of maldives|maldives|maldive islands
malawi|nyasaland|republic of malawi
mexico|united mexican states|estados unidos mexicanos
malaysia
republic of mozambique|mocambique|mozambique
namibia|republic of namibia|south west africa
new caledonia|nouvelle-caledonie|kanaky
niger|republic of the niger
norfolk island
naija|federal republic of nigeria|nigeria
republic of nicaragua|nicaragua
nederlanden|the netherlands|kingdom of the netherlands|netherlands|holland
kingdom of norway|norge|norway
nepal|federal democratic republic of nepal
pleasant island|naoero|nauru|republic of nauru
niue
zealandia nova|new zeeland|new zealand|aotearoa
muscat and oman|uman|sultanate of oman|oman
canal zone|panama|republic of panama
peru|republic of peru
french oceania|french polynesia
independent state of papua new guinea|papua new guinea
republic of the philippines|philippines|philippine islands
pakistan|islamic republic of pakistan
poland|republic of poland|polska
saint pierre and miquelon
pitcairn islands|pitcairn
borinquen|boriken|porto rico|boriquen|puerto rico
the state of palestine|palestinian territory|palestine
lusitania|portuguese republic|portugal
republic of palau|belau|palau|pelew
paraguay|republic of paraguay
qatar|state of qatar
reunion|reunion island|bourbon island
roumania|romania|rumania
serbia|srbija|republic of serbia|yugoslavia
russian federation|ussr|russia|soviet union|rossiyskaya federatsiya
rwandese republic|the land of a thousand hills|rwanda
kingdom of saudi arabia|saudi arabia
solomon islands
seychelles|republic of seychelles
as-sudan|al-sudan|republic of the sudan|sudan
sverige|kingdom of sweden|sweden
lion city|republic of singapore|garden city|singapore
saint helena|saint helena, ascension and tristan da cunha
slovenia|slovenija|republic of slovenia
svalbard and jan mayen
slovakia|slovensko|slovak republic
republic of sierra leone|sierra leone
san marino|republic of san marino
republic of senegal|senegal
somalia|federal republic of somalia|somali republic
surrinam|suriname|surinam|dutch guiana|republic of suriname
south sudan|republic of south sudan
sao tome and principe|democratic republic of sao tome and principe
salvador|republic of el salvador|el salvador
land sint maarten|sint maarten|dutch sint maarten|country of sint maarten|saint martin (dutch part)|saint martin|sint martin|sint maarten (dutch part)
surya|syria|syrian arab republic
umbuso weswatini|eswatini|kingdom of eswatini|swaziland
turks and caicos islands|turks and caicos
republic of chad|chad
french southern territories|french southern and antarctic lands
togo|togolese republic
thailand|siam|land of smiles|kingdom of thailand
republic of tajikistan|tajikistan
tokelau|union islands
east timor|timor-leste|timor leste|democratic republic of timor-leste
turkmenistan|turkmenia
tunisia|republic of tunisia
tonga islands|kingdom of tonga|friendly islands|tonga
republic of turkiye|turkey|turkiye
republic of trinidad and tobago|trinidad and tobago
ellice islands|tuvalu
chinese taipei|taiwan|tai-oan|tai-uan|roc|republic of china|formosa
tanganyika and zanzibar|united republic of tanzania|tanzania
ukraine|ukraina|ukrainia
pearl of africa|republic of uganda|uganda|ouganda
united states minor outlying islands|usmoi
america|united states of america|united states
uruguay|eastern republic of uruguay|banda oriental
republic of uzbekistan|uzbekistan
holy see|papal state|vatican city state|vatican|the vatican|vatican city
saint vincent and the grenadines
venezuela|bolivarian republic of venezuela
british virgin islands
american virgin islands|usvi|united states virgin islands|us virgin islands|u.s. virgin islands|virgin islands of the united states
socialist republic of viet nam|viet nam|vietnam
republic of vanuatu|vanuatu|new hebrides
wallis and futuna
western samoa|independent state of samoa|samoa
yemen|republic of yemen|south arabia
mayotte
mzansi|south africa|republic of south africa
northern rhodesia|republic of zambia|zambia
southern rhodesia|republic of zimbabwe|zimbabwe
